proof assistant	証明アシスタント	Coqのような、証明を記述・検証するツールの総称。特に対話型のもののみを指す場合もある。「定理証明支援系」と訳されることが多いが、個人的な好みにより「証明アシスタント」を採用した。
judgments	判断	演繹体系の構成要素の一つ。論理的判断とも。本文書では型付け判断(x:T)のみを扱う。
check	検査
specification	仕様
properties	性質
tactic	タクティック	Coqの証明を記述するためのコマンド。
develop	構築	証明に対して用いる。
develop	開発	プログラムに対して用いる。
user	ユーザ
index	索引
documentation	文書	使われ方を見るに「記述」みたいな言い方でも良さそうな気がする
part	部	マニュアルの構造を示す場合
chapter	章
theorem	定理
proof	証明
proof engine	証明エンジン
evaluation	評価
induction principle	帰納法の原理
batch mode	コンパイルモード
recursive type	再帰型
Addendum	付録
vernacular	Vernacular	国内では常に大文字始まりにしているのでそれに従う。
preamble	はじめに
The language	言語	第一部
The proof engine	証明エンジン	第二部
User extensions	ユーザ拡張	第三部
Practical tools	実用ツール	第四部
specification language	仕様記述言語
theory	理論
axiom	公理
parameter	パラメータ
lemma	補題
object	対象
syntax	構文
section	節
grammar	文法
notation	記法
expression	式
parse	パース
blank	空白記号
space	スペース
identifier	識別子
literal	リテラル
entry	エントリ	「非終端記号」と同義と思って差し支えない
qualifier	修飾子	スコープ修飾子にのみ使われる
qualified identifier	修飾付き識別子	m.xの形式で書かれた識別子
quantifier	量化子	全称量化子∀と存在量化子∃の総称
modifier	指定子	タクティックなどに追加の情報を与える際に用いる要素
term	項
type	型
constant	定数
remark	注意	訳さない方が伝わるかもしれない
fact	事実
variable	変数
inductive type	帰納型
sort	ソート	型の型
proposition	命題
universe	ユニバース	型の集合的なもの
binder	束縛子
bind	束縛
abstractions	関数抽象
product	プロダクト	forall x:A, t の形で表される項
dependent product	依存積
application	関数適用
associativity	結合性
cast	キャスト
virtual machine	仮想マシン
subterm	部分項
let-in definition	let-in定義
construction	構造	gallinaにおける(部分式を持つ?)構文
pattern match	パターンマッチ	動詞(pattern match)も名刺(pattern matching)も等しく「パターンマッチ」とする
